XXXXXXXXXXXXXXXXXXXXXXXXXXXXXXXXXXXXXXXXXXXXXXXXXXXXXXXXXXXXXXXXXXXXXXXXXXXXXXXXXXXXXXXXXXXXXXXXXXXXXXXXX
XXXXXXXXXXXXXXXXXXXXXXXXXXXXXXXXXXXXXXXXXXXXXXXXXXXXXXXXXXXXXXXXXXXXXXXXXXXXXXXXXXXXXXXXXXXXXXXXXXXXXXXXX
XXXXXXXXXXXXXXXXXXXXXXXXXXXXXXXXXXXXXXXXXXXXXXXXXXXXXXXXXXXXXXXXXXXXXXXXXXXXXXXXXXXXXXXXXXXXXXXXXXXXXXXXX
XXXXXXXXXXXXXXXXXXXXXXXXXXXXXXXXXXXXXXXXXXXXXXXXXXXXXXXXXXXXXXXXXXXXXXXXXXXXXXXXXXXXXXXXXXXXXXXXXXXXXXXXX
XXXXXXXXXXXXXXXXXXXXXXXXXXXXXXXXXXXXXXXXXXXXXXXXXXXXXXXXXXXXXXXXXXXXXXXXXXXXXXXXXXXXXXXXXXXXXXXXXXXXXXXXX
XXXXXXXXXXXXXXXXXXWWWWWWWWXXXXXXXXXXXXXXXXXXXXXXXXXXXXXXXXXXXXXXXXWWWWWWWWWWXXXXXXXXXXXXXXXXXXXXXXXXXXXXX
XXXXXXXXXXXXXXXXXWWWWWWWWWWWWWWWWWWXXXXXXXXXXXXXXXXXXXXWWWWWWWWWWWWWWWWWWWWWWWWWWWXXWWWWWXXXXXXXXXXXXXXXX
XXXXXXXXXXXXXXXWWWWWXXXXWWWWWWWWWWWWWWWWWWWWWWWWWWWWWWWWWWWWWWWWWWWXXXXXXXXWWWWWWWWWWWWWWWWWWXXXXXXXXXXXX
XXXXXXXXXXXXXXWWWWWXXXXXXXXXXXXXXWWWWWWWWWWWWWWWWWWWWWWWXXXXXXXXXXXXXXXXXXXXXXXXXWWWWWXXWWWWWWWWXXXXXXXXX
XXXXXXXXXXXXXWWWWXXXXXXXXXXXXXXXXXXXXXXXXXXXXFFFFOFFXXXXXXXXXXXXXXXXXXXXXXXXXXXXXXXXXXXXXXXXWWWWXXXXXXXXX
XXXXXXXXXXXXWWWWXXXXXXXXXXXXXXXXXXXXXXXXXXXXXFFFFFFFXXXXXXXXXXXXXXXXXXXXXXXXXXXXXXXXXXXXXXXXXXWWXXXXXXXXX
XXXXXXXXXXWWWWWXXXXXXXXXXXXXXXXXXXXXXXXXXXXXXFFFFAFFXXXXXXXXXXXXXXXXXXXXXXXXXXXXXXXXXXXXXXXXXXWWXXXXXXXXX
XXXXXXXXXWWWWXXXXXXXXFFFFFFFFFFFFFFFFFFFFFFFFFFFFFFFFFFFFFFFFFFFFFFFFFFFFFFFFFFFXXXXXXXXXXXXXXWWXXXXXXXXX
XXXXXXXWWWWXXXXXXXXXXFFFFFFFFFFFFFFFFFFFFFFFFFFFFFFFFFFFFFFFFFFFFFFFFFFFFFFFFFFFXXXXXXXXXXXXXXWWXXXXXXXXX
XXXXXXWWWWXXXXXXXXXXXFFFFFFFFFFFFFFFFFFFFFFFFFFFFFFFFFFFFFFFFFFFFFFFFFFFFFFFFFFFXXXXXXXXXXXXXXWWWXXXXXXXX
XXXXXXWWWXXXXXXXXXXXXFFFFFFFFFFFFFXXXXXXXXXXXXXXXXXXXXXXXXXXXXXXXXXXFFFFFFFFFFFFXXXXXXXXXXXXXXWWWWWXXXXXX
XXXXXXWWWXXXXXXXXXXXXFFFFFFFXXXXXXXXXXXXXXXXXXXXXXXXXXXXXXXXXXXXXXXXXXXFFFFFFFFFXXXXXXXXXXXXXXXWWWWXXXXXX
XXXXXXWWWWWXXXXXXXXXXFFFFFFXXXXXXXXXXXXXXXXXXXXXXXXXXXXXXXXXXXXXXXXXXXXFFFFFFFFFXXXXXXXXXXXXXXXXXWWXXXXXX
XXXXXXXWWWWXXXXXXXXXXFFFFFFXXXXXXXXXXXXXXXXXXXXXXXXXXXXXXXXXXXXXXXXXXXXFFFFFFFFFXXXXXXXXXXXXXXXXWWWXXXXXX
XXXXXXXXXWWXXXXXXXXXXFFFFFFXXXXXXXXXXXXXXXXXXXXXXXXXXXXXXXXXXXXXXXXXXXXFFFFFFFFFXXXXXXXXXXXXXXXXWWWXXXXXX
XXXXXXXXWWWXXXXXXXXXXFFFFFFXXXXXXXXXXXXXXXXXXXXXXXXXXXXXXXXXXXXXXXXXXXXFFFFFFFFFXXXXXXXXXXXXXXXWWWXXXXXXX
XXXXXXXWWWWXXXXXXXXXXFFFFFFXXXXXXXXXXXXXXXXXXXXXXXXXXXXXXXXXXXXXXXXXXXXFFFFFFFFFXXXXXXXXXXXXXXWWWWXXXXXXX
XXXXXXXWWWXXXXXXXXXXXFFFFFFXXXXXXXXXXXXXXXXXXXXXXXXXXXXXXXXXXXXXXXXXXXXFFFFFFFFFXXXXXXXXXXXXXWWWWXXXXXXXX
XXXXXXWWWXXXXXXXXXXXXFFFFFFXXXXXXXXXXXXXXXXXXXXXXXXXXXXXXXXXXXXXXXXXXXXFFFFFFFFFXXXXXXXXXXXXWWWWXXXXXXXXX
XXXXXXWWWXXXXXXXXXXXXFFFFFFXXXXXXXXXXXXXXXXXXXXXXXXXXXXXXXXXXXXXXXXXXXXFFFFFFFFFXXXXXXXXXXXWWWWXXXXXXXXXX
XXXXXXWWXXXXXXXXXXXXXFFFFFFXXXXXXXXXXXXXXXXXXXXXXXXXXXXXXXXXXXXXXXXXXXXFFFFFFFFFXXXXXXXXXXXWWWXXXXXXXXXXX
XXXXXXWWXXXXXXXXXXXXXFFFFFFXXXXXXXXXXXXXXXXXXXXXXXXXXXXXXXXXXXXXXXXXXXXFFFFFFFFFXXXXXXXXXXWWWXXXXXXXXXXXX
XXXXXXWWXXXXXXXXXXXXXFFFFFFXXXXXXXXXXXXXXXXXXXXXXXXXXXXXXXXXXXXXXXXXXXXFFFFFFPFFXXXXXXXXXXWWWXXXXXXXXXXXX
XXXXXXWWWXXXXXXXXXXXXFFFFFFXXXXXXXXXXXXXXXXXXXXXXXXXXXXXXXXXXXXXXXXXXXXFFFFFFFFFXXXXXXXXXXWWWXXXXXXXXXXXX
XXXXXXWWWXXXXXXXXXXXXFFFFFFXXXXXXXXXXXXXXXXXXXXXXXXXXXXXXXXXXXXXXXXXXXXFFFFFFFFFXXXXXXXXXXXWWWXXXXXXXXXXX
XXXXXXXWWWXXXXXXXXXXXFFFFFFXXXXXXXXXXXWWWWWWWWWWWWXXXXXXXXXXXXXXXXXXXXXFFFFFFFFFXXXXXXXXXXXWWWXXXXXXXXXXX
XXXXXXXWWWXXXXXXXXXXXFFFFFFXXXXXXXXWWWWWWWWWWWWWWWWWWWWWWWWWWWWWXXXXXXXFFFFFFYFFXXXXXXXXXXWWWWXXXXXXXXXXX
XXXXXXXXWWWWXXXXXXXXWWWWWWWWWWXWWWWWWWWWXXXXXXXXWWWWWWWWWWWWWWWWWWWWWXXWWWWWWWWWWWXXXWWWWWWWWXXXXXXXXXXXX
XXXXXXXXWWWWWWWWWWWWWWWWWWWWWWWWWWWWWXXXXXXXXXXXXXXXXXXXXXXXXXWWWWWWWWWWWWWWWWWWWWWWWWWWWWWWXXXXXXXXXXXXX
XXXXXXXXXXWWWWWWWWWWWWWWWWWWWWWWWXXXXXXXXXXXXXXXXXXXXXXXXXXXXXXXXXXWWWWWWWWWWWWWWWWWWWWXXXXXXXXXXXXXXXXXX
XXXXXXXXXXXXXWWWWWWWWWXXXXXXXXXXXXXXXXXXXXXXXXXXXXXXXXXXXXXXXXXXXXXXXXXXXXXXXXXXXXXXXXXXXXXXXXXXXXXXXXXXX
XXXXXXXXXXXXXWWWWWWWXXXXXXXXXXXXXXXXXXXXXXXXXXXXXXXXXXXXXXXXXXXXXXXXXXXXXXXXXXXXXXXXXXXXXXXXXXXXXXXXXXXXX
XXXXXXXXXXXXXXXXXXXXXXXXXXXXXXXXXXXXXXXXXXXXXXXXXXXXXXXXXXXXXXXXXXXXXXXXXXXXXXXXXXXXXXXXXXXXXXXXXXXXXXXXX
XXXXXXXXXXXXXXXXXXXXXXXXXXXXXXXXXXXXXXXXXXXXXXXXXXXXXXXXXXXXXXXXXXXXXXXXXXXXXXXXXXXXXXXXXXXXXXXXXXXXXXXXX
XXXXXXXXXXXXXXXXXXXXXXXXXXXXXXXXXXXXXXXXXXXXXXXXXXXXXXXXXXXXXXXXXXXXXXXXXXXXXXXXXXXXXXXXXXXXXXXXXXXXXXXXX