XXXXXXXXXXXXXXXXXXXXXXXXXXXXXXXXXXXXXXXXXXXXXXXXXXXXXXXXXXXXXXXXXXXXXXXXXXXXXXXXXXXXXXXXXXXXXXXXXXXXXXXXXXXXXXXXXXXX
XXXXXXXXXXXXXXXXXXXXXXXXXXXXXXXXXXXXXXXXXXXXXXXXXXXXXXXXXXXXXXXXXXXXXXXXXXXXXXXXXXXXXXXXXXXXXXXXXXXXXXXXXXXXXXXXXXXX
XXXXXXXXXXXXXXXXXXXXXXXXXXXXXXXXXXXXXXXXXXXXXXXXXXXXXXXXXXXXXXXXXXXXXXXXXXXXXXXXXXXXXXXXXXXXXXXXXXXXXXXXXXXXXXXXXXXX
XXXXXXXXXXXXXXXXXXXXXXXXXXXXXXXXXXXXXXXXXXXXXXXXXXXXXXXXXXXXXXXXXXXXXXXXXXXXXXXXXXXXXXXXXXXXXXXXXXXXXXXXXXXXXXXXXXXX
XXXXXXXXXXXXXXXXXXXXXXXXXXXXXXXXXXXXXXXXXXXXXXXXXXXXXXXXXXXXXXXXXXXXXXXXXXXXXXXXXXXXXXXXXXXXXXXXXXXXXXXXXXXXXXXXXXXX
XXXXXXXXXXXXXXXXXXXXXXXXXXXXXXXXXXXXXXXXXXXXXXXXXXXXXXXXXXXXXXXXXXXXXXXXXXXXXXXXXXXXXXXXXXXXXXXXXXXXXXXXXXXXXXXXXXXX
XXXXXXXXXXXXXXXXXXXXXXXXXXXXXXXXXXXXXXXXXXXXXXXXXXXXXXXXXXXXXXXXXXXXXXXXXXXXXXXXXXXXXXXXXXXXXXXXXXXXXXXXXXXXXXXXXXXX
XXXXXXXXXXXXXXXXXXXXXXXXXXXXXXXXXXXXXXXXXXXXXXXXXXXXXXXXXXXXXXXXXXXXXXXXXXXXXXXXXXXXXXXXXXXXXXXXXXXXXXXXXXXXXXXXXXXX
XXXXXXXXXXXXXXXXXXXXXXXXXXXXXXXXXXXXXXXXXXXXXXXXXXXXXXXXXXXXXXXXXXXXXXXXXXXXXXXXXXXXXXXXXXXXXXXXXXXXXXXXXXXXXXXXXXXX
XXXXXXXXXXXXXXXXXXXXXXXXXXXXXXXXXXXXXXXXXXXXXXXXXXXXXXXXXXXXXXXXXXXXXXXXXXXXXXXXXXXXXXXXXXXXXXXXXXXXXXXXXXXXXXXXXXXX
XXXXXXXXXXXXXXXXXXXXXXXXXXXXXXXXXXXXXXXXXXXXXXXXXXXXXXXXXXXXXXXXXXXXXXXXXXXXXXXXXXXXXXXXXXXXXXXXXXXXXXXXXXXXXXXXXXXX
XXXXXXXXXXXXXXXXXXXXXXXXXXXXXXXXXXXXXXXXXXXXXXXXXXXXXXXXXXXXXXXXXXXXXXXXXXXXXXXXXXXXXXXXXXXXXXXXXXXXXXXXXXXXXXXXXXXX
XXXXXXXXXXXXXXXXXXXXXXXXXXXXXXXWWWWFWWWWWfWWWWWWWfWWWWWWWWFWWWWWWWWWWFWXXXXXXXXXXXXXXXXXXXXXXXXXXXXXXXXXXXXXXXXXXXXX
XXXXXXXXXXXXXXXXXXXXXXXXXXXXXXXWfWWWWWFWFWWFWWWFWWffWWFWWWWWWFWWWWWFWWWXXXXXXXXXXXXXXXXXXXXXXXXXXXXXXXXXXXXXXXXXXXXX
XXXXXXXXXXXXXXXXXXXXXXXXXXXXXWWWFWZZZZZZZZZZZZZZZZZZZZZZZZZZZZZZZZZZWWWWXXXXXXXXXXXXXXXXXXXXXXXXXXXXXXXXXXXXXXXXXXXX
XXXXXXXXXXXXXXXXXXXXXXXXXXXXXWWWWWZZZZZZZZZZZZZZZZZZZZZZZZZZZZZZZZZZWWFWXXXXXXXXXXXXXXXXXXXXXXXXXXXXXXXXXXXXXXXXXXXX
XXXXXXXXXXXXXXXXXXXXXXXXXXXWWWWWFZZZbZZZZZZZZZZZZZZZZZZZZZZZZZZZZZZZWWWWWXXXXXXXXXXXXXXXXXXXXXXXXXXXXXXXXXXXXXXXXXXX
XXXXXXXXXXXXXXXXXXXXXXXXXXXWWWWWWZZZZZZZZZZZZZZZZZZZZZZZZZZZZZZcZZZZZZZWfWFXXXXXXXXXXXXXXXXXXXXXXXXXXXXXXXXXXXXXXXXX
XXXXXXXXXXXXXXXXXXXXXXXXXXXXWWFWWZZZZZZZZWWWWWWZZZpZZZZZZZZZZZZZZZZZZZZWWWWWXXXXXXXXXXXXXXXXXXXXXXXXXXXXXXXXXXXXXXXX
XXXXXXXXXXXXXXXXXXXXXXXXXXXXWfWWWZZZbZZWWFWWWFWZZZZZZZZZZZZZZZZZZpZZZZZZZWFWWWXXXXXXXXXXXXXXXXXXXXXXXXXXXXXXXXXXXXXX
XXXXXXXXXXXXXXXXXXXXXXXXXXWWWZZZZZZZZZZWWWWWWWWZZZZZZZZZZZZcZZZZZZZZZZZZZZZZWWfWWXXXXXXXXXXXXXXXXXXXXXXXXXXXXXXXXXXX
XXXXXXXXXXXXXXXXXXXXXXXXXXFWWZZZZbZZZZZZZZZZZZZZZZZZZZZZZZZZZZZZZZZcZZZZZZZZZZWWWXXXXXXXXXXXXXXXXXXXXXXXXXXXXXXXXXXX
XXXXXXXXXXXXXXXXXXXXXXXXXXWWWZZZZZZbZZZZbZZZZZZZZZZbZZZZZZZZZZZZZZZZZZZZZZZZZZWWfXXXXXXXXXXXXXXXXXXXXXXXXXXXXXXXXXXX
XXXXXXXXXXXXXXXXXXXXXXXXXXWWFWZZZZZZZZZZZZZZZZZZZZZZZZZZZZZZZZZZZZZZZZZZZZZZZZWWWWWXXXXXXXXXXXXXXXXXXXXXXXXXXXXXXXXX
XXXXXXXXXXXXXXXXXXXXXXXXXXWWWWZZZZZZbZZZZZZWWWZZZZZZZZZZZZWWWWZZZWWWWZZZZZZZZZZZZWFWXXXXXXXXXXXXXXXXXXXXXXXXXXXXXXXX
XXXXXXXXXXXXXXXXXXXXXXXXWWWZZZZZZZZZZZZZWWWWWWZZZZZZZZZZZZWWWWWFWWWFWZZZZZZZZZZZZWWWXXXXXXXXXXXXXXXXXXXXXXXXXXXXXXXX
XXXXXXXXXXXXXXXXXXXXXXXXWWfZZbZZbZZZZWWWFWWWWWWZZZZZpZZZZZZZZWWWWWWZZZZZZZZZZZZZZWWFXXXXXXXXXXXXXXXXXXXXXXXXXXXXXXXX
XXXXXXXXXXXXXXXXXXXXXXXXWWWZZZbZZZZWWWWWWWWWWWFWWZZZZZZZZZZZZZZZZZZZZZcZZZZZZZZZZWWWXXXXXXXXXXXXXXXXXXXXXXXXXXXXXXXX
XXXXXXXXXXXXXXXXXXXXXXXXWWfZZZZZZZZWWWWFWWWWfWWWWZZZZZZZZZZZZZZZZZZZZZZZZZZZZZZZZWfWXXXXXXXXXXXXXXXXXXXXXXXXXXXXXXXX
XXXXXXXXXXXXXXXXXXXXXXXXXXWWWZZZZZZZZWWWWWWWWWZZZZZZZZcZZZZZZZZcZZZZZZZZZpZZZZZZWWWWFXXXXXXXXXXXXXXXXXXXXXXXXXXXXXXX
XXXXXXXXXXXXXXXXXXXXXXXXXXWfWZZZZZZZZZZZZZZZZZZZZZZZZZZZZZZZZZZZZZZZZZZZZZZZZZZZWfWXXXXXXXXXXXXXXXXXXXXXXXXXXXXXXXXX
XXXXXXXXXXXXXXXXXXXXXXXXXXWWfZZZZZZZZZZZZZZZZZZZZZZZZZZZZZZZZZZZZZZZZZZZZcZZZZZZWWWFXXXXXXXXXXXXXXXXXXXXXXXXXXXXXXXX
XXXXXXXXXXXXXXXXXXXXXXXXXXWWWZZZZZZZZZZZpZZZZZZZZZZZZZZZZZWWWWWWWWWWWZZZZZZZZZZZZWWWXXXXXXXXXXXXXXXXXXXXXXXXXXXXXXXX
XXXXXXXXXXXXXXXXXXXXXXXXWWFZZZZZZZZZZZZZZZZZZZZZZZZcZZZZZZWWWFWWWWFWWZZZZZZZZZZZZWWWXXXXXXXXXXXXXXXXXXXXXXXXXXXXXXXX
XXXXXXXXXXXXXXXXXXXXXXXXWWFZZZZZZZZZZZZZZcZZZZZZZZZZZZZZZZZZZWWWfWWZZZZZZZZZZZZZZWFWXXXXXXXXXXXXXXXXXXXXXXXXXXXXXXXX
XXXXXXXXXXXXXXXXXXXXXXXXWWWZZZZZpZZZZZZZZZZZZZZZpZZZZZZZZZZZZZZWWZZZZZZZZZZZZZZZZWWWfXXXXXXXXXXXXXXXXXXXXXXXXXXXXXXX
XXXXXXXXXXXXXXXXXXXXXXXXWfWZZZZZZZZZpZZZZZZZZZpZZZZZZZZZZZZZZZZZZZZZZZZZZZZZZZZZZWfWXXXXXXXXXXXXXXXXXXXXXXXXXXXXXXXX
XXXXXXXXXXXXXXXXXXXXXXXXXXWWWZZZZZZCZZZZZZZZZZZZZZZZZZZZZZZZZZZZZZZZpZZZZZZZZZZZWWfXXXXXXXXXXXXXXXXXXXXXXXXXXXXXXXXX
XXXXXXXXXXXXXXXXXXXXXXXXXXWFWZZZZZZpZZZZZZZZZZZZZZZZZZZZZZZZZZZZZZZZZZZZZZZZZZZZWFWXXXXXXXXXXXXXXXXXXXXXXXXXXXXXXXXX
XXXXXXXXXXXXXXXXXXXXXXXXXXWWWWZZZZZZZZZCZZZcZZZZZZZWWWWWWfWZZZZZZZZZZZZZZZZZZZZZWWWXXXXXXXXXXXXXXXXXXXXXXXXXXXXXXXXX
XXXXXXXXXXXXXXXXXXXXXXXXXXWFWWZZZZZCZZZZpZZZZZZZZZZWWFWWWWWZZZZZZZZZZOOOOZZZZZZZFWWXXXXXXXXXXXXXXXXXXXXXXXXXXXXXXXXX
XXXXXXXXXXXXXXXXXXXXXXXXXXWWfWZZZZZZZZZZZZZCZZZZZZZZZWWWWWWZZZZZZZZZZOOOOZZZZZZZWWWXXXXXXXXXXXXXXXXXXXXXXXXXXXXXXXXX
XXXXXXXXXXXXXXXXXXXXXXXXXXWWWWZZZZZpZZZZZZZZZZZZZZZZZZZZZZZZZZZZZZZZZOOOOZZZZZZZZWFWXXXXXXXXXXXXXXXXXXXXXXXXXXXXXXXX
XXXXXXXXXXXXXXXXXXXXXXXXXXWWFZZZZZZZZZZcZZZZZZZZZZZZCZZZZZZZZZZPPPZZZZOOOZZZZZZZZWWWXXXXXXXXXXXXXXXXXXXXXXXXXXXXXXXX
XXXXXXXXXXXXXXXXXXXXXXXXXXWWWZZZZZZZZZZZZZZZZZCZZZZZZZZZCZZZZZZPPPPPPPZZZZZZZZZZZWWFXXXXXXXXXXXXXXXXXXXXXXXXXXXXXXXX
XXXXXXXXXXXXXXXXXXXXXXXXWWWWZZZZZZZZZZZZZZZZZZZZZZZZZZZZZZZZZZZPPPPPPPZZZZZpZZZZZWWWXXXXXXXXXXXXXXXXXXXXXXXXXXXXXXXX
XXXXXXXXXXXXXXXXXXXXXXXXWWfWZZZoZZZZZZZoZZZZZWWWWFWWWWZZZZZZZZZZZZZZZZZZZZZZZZZZZFWWXXXXXXXXXXXXXXXXXXXXXXXXXXXXXXXX
XXXXXXXXXXXXXXXXXXXXXXXXXWWWZZZZZZZZZZZZZZZWWfWWWWWWWWWZZZZZZZZZZZZCZZZZpZZZZZWWWWWXXXXXXXXXXXXXXXXXXXXXXXXXXXXXXXXX
XXXXXXXXXXXXXXXXXXXXXXXXXWWWZZZZZZZoZZZZZZZWWWffWWWFWWWZZZZZZZpZZZZZZZZCZZZZZZWfWXXXXXXXXXXXXXXXXXXXXXXXXXXXXXXXXXXX
XXXXXXXXXXXXXXXXXXXXXXXXXXWFWZZZZZZZZZZZZZZZWWWWWWWWWWZZZZZZZZZZCZZZZZZZZZZZZZWWWWWXXXXXXXXXXXXXXXXXXXXXXXXXXXXXXXXX
XXXXXXXXXXXXXXXXXXXXXXXXXXWWWZZZZZpZZZZZZZZZZZZZZZZZZZZZZZZZZZZZZZZCZZZZZZZZZZWFWWWXXXXXXXXXXXXXXXXXXXXXXXXXXXXXXXXX
XXXXXXXXXXXXXXXXXXXXXXXXXXWWWZZZZZZZZoZZZpZZZZZZZZZZZZZZZZZZZZZZZZZZZZZZZZoZZZZZWfWXXXXXXXXXXXXXXXXXXXXXXXXXXXXXXXXX
XXXXXXXXXXXXXXXXXXXXXXXXXXWFWZZZZZZZZZZZZZZZZZZZZZZZZZZZZZZZpZZZZZZZZZZZZZZZZZZZWWFXXXXXXXXXXXXXXXXXXXXXXXXXXXXXXXXX
XXXXXXXXXXXXXXXXXXXXXXXXXXWWWZZZZZZZZZZWWWWZZZZZZZBBBBBBZZZZZZZZZZWWZZZZZZZoZZZZWFWXXXXXXXXXXXXXXXXXXXXXXXXXXXXXXXXX
XXXXXXXXXXXXXXXXXXXXXXXXXXWWfWZZZZZZZZZWWFWWZZZZZZBBBBBBBZZZoZZZZZWWfWZZZZZZZZZZWWWXXXXXXXXXXXXXXXXXXXXXXXXXXXXXXXXX
XXXXXXXXXXXXXXXXXXXXXXXXXXWWWWWWZZZZZZZWWWFWZZZZZBBBBBBBBZZZZZZZZWWWWZZZZZZoZZZWfWXXXXXXXXXXXXXXXXXXXXXXXXXXXXXXXXXX
XXXXXXXXXXXXXXXXXXXXXXXXXXXXXWWWWWZZZZZZZZZZZZZZZBBBBBBBBZZZZZZZZFWWWZZZZZZZZZZWWWXXXXXXXXXXXXXXXXXXXXXXXXXXXXXXXXXX
XXXXXXXXXXXXXXXXXXXXXXXXXXXXXWfWWWZZZZZZoZZZZZZZZZZBBBBBBZZZZZZZZZZZZZZZZZZZZZWWWWXXXXXXXXXXXXXXXXXXXXXXXXXXXXXXXXXX
XXXXXXXXXXXXXXXXXXXXXXXXXXXXXWWWWWZZZZZZZZZZZZZZZZZZZZZZZZZZZZZZZoZZZZZZZZpZZZWWWXXXXXXXXXXXXXXXXXXXXXXXXXXXXXXXXXXX
XXXXXXXXXXXXXXXXXXXXXXXXXXXXXWWWfWZZZZZZZZZZZZoZZZZZZZZZZZZZZZZZZZZZZZZZoZZZZZFWWXXXXXXXXXXXXXXXXXXXXXXXXXXXXXXXXXXX
XXXXXXXXXXXXXXXXXXXXXXXXXXXXXWWWWWZZZZoZZZZZZZZZZZZZZWWWWWWWWZZZZZZZZZZZZZZZZZWWWXXXXXXXXXXXXXXXXXXXXXXXXXXXXXXXXXXX
XXXXXXXXXXXXXXXXXXXXXXXXXXXXXWWFZZZZZZZZZZZZZZZZZZZZZWWFWWWWFZZZZoZZZpZZZZoZZZZWWWXXXXXXXXXXXXXXXXXXXXXXXXXXXXXXXXXX
XXXXXXXXXXXXXXXXXXXXXXXXXXXXXWWWZZZZZZZZZZZZZZZZZZZZZWWWWfWWWZZZZZZZZZZZZZpZZZZWWWXXXXXXXXXXXXXXXXXXXXXXXXXXXXXXXXXX
XXXXXXXXXXXXXXXXXXXXXXXXXXXXXWWWZZZZZZZZZZWWWZZZZZZZZZWWWWfWWZZZZZZZZZZZZZZZZZWWWFXXXXXXXXXXXXXXXXXXXXXXXXXXXXXXXXXX
XXXXXXXXXXXXXXXXXXXXXXXXXXXXXWFWZZZZZZZZWWWWWZZZZZZZZZZWWWWWWZZZZZoZZZZZZZZZWWWWWXXXXXXXXXXXXXXXXXXXXXXXXXXXXXXXXXXX
XXXXXXXXXXXXXXXXXXXXXXXXXXXXXWWWZZZZZZZZWFWWWZZZZZZZZZZZZZZZZZZZZZZZZZZZZZZWfWWWXXXXXXXXXXXXXXXXXXXXXXXXXXXXXXXXXXXX
XXXXXXXXXXXXXXXXXXXXXXXXXXXXXXXWWWZZZZZZWWWWWZZZZZZoZZZZZZZZZZZZZZZZZZZWWWWWWWXXXXXXXXXXXXXXXXXXXXXXXXXXXXXXXXXXXXXX
XXXXXXXXXXXXXXXXXXXXXXXXXXXXXXXWfWZZZZZZZZZZZZZZZZZZZZZZZZZZZZZZZpZZZZZWFWWWXXXXXXXXXXXXXXXXXXXXXXXXXXXXXXXXXXXXXXXX
XXXXXXXXXXXXXXXXXXXXXXXXXXXXXXXWWWFWWWZZZZZZZZpZZZZZZZZZZZZZpZZZZZZZZWfWWXXXXXXXXXXXXXXXXXXXXXXXXXXXXXXXXXXXXXXXXXXX
XXXXXXXXXXXXXXXXXXXXXXXXXXXXXXXWWWWWfWZZZZZZZZZZZZZZZZZZZZZZZZZZZZZZZWWWWXXXXXXXXXXXXXXXXXXXXXXXXXXXXXXXXXXXXXXXXXXX
XXXXXXXXXXXXXXXXXXXXXXXXXXXXXXXXXWWWWWZZZZZpZZZZZZZZZZZZZZZZZZZZZZZZZWWFWXXXXXXXXXXXXXXXXXXXXXXXXXXXXXXXXXXXXXXXXXXX
XXXXXXXXXXXXXXXXXXXXXXXXXXXXXXXXXWWFWWZZZZZZZZZZZZZZZZZZZZZZZZZZpZZZZWFWWXXXXXXXXXXXXXXXXXXXXXXXXXXXXXXXXXXXXXXXXXXX
XXXXXXXXXXXXXXXXXXXXXXXXXXXXXXXXXWWWWWZZZZZZZZZZZZZZZZZZZZZZZZZZZZZZZWWWWXXXXXXXXXXXXXXXXXXXXXXXXXXXXXXXXXXXXXXXXXXX
XXXXXXXXXXXXXXXXXXXXXXXXXXXXXXXXXXXXWWFWWWWWWWWWFWWWWWWWWWffWWWfWWWWWWWXXXXXXXXXXXXXXXXXXXXXXXXXXXXXXXXXXXXXXXXXXXXX
XXXXXXXXXXXXXXXXXXXXXXXXXXXXXXXXXXXXWWWWWWWWWWFWWWWWWWWWfWWWWWfWWWWWFWWXXXXXXXXXXXXXXXXXXXXXXXXXXXXXXXXXXXXXXXXXXXXX
XXXXXXXXXXXXXXXXXXXXXXXXXXXXXXXXXXXXXXXXXXXXXXXXXXXXXXXXXXXXXXXXXXXXXXXXXXXXXXXXXXXXXXXXXXXXXXXXXXXXXXXXXXXXXXXXXXXX
XXXXXXXXXXXXXXXXXXXXXXXXXXXXXXXXXXXXXXXXXXXXXXXXXXXXXXXXXXXXXXXXXXXXXXXXXXXXXXXXXXXXXXXXXXXXXXXXXXXXXXXXXXXXXXXXXXXX
XXXXXXXXXXXXXXXXXXXXXXXXXXXXXXXXXXXXXXXXXXXXXXXXXXXXXXXXXXXXXXXXXXXXXXXXXXXXXXXXXXXXXXXXXXXXXXXXXXXXXXXXXXXXXXXXXXXX
XXXXXXXXXXXXXXXXXXXXXXXXXXXXXXXXXXXXXXXXXXXXXXXXXXXXXXXXXXXXXXXXXXXXXXXXXXXXXXXXXXXXXXXXXXXXXXXXXXXXXXXXXXXXXXXXXXXX
XXXXXXXXXXXXXXXXXXXXXXXXXXXXXXXXXXXXXXXXXXXXXXXXXXXXXXXXXXXXXXXXXXXXXXXXXXXXXXXXXXXXXXXXXXXXXXXXXXXXXXXXXXXXXXXXXXXX
XXXXXXXXXXXXXXXXXXXXXXXXXXXXXXXXXXXXXXXXXXXXXXXXXXXXXXXXXXXXXXXXXXXXXXXXXXXXXXXXXXXXXXXXXXXXXXXXXXXXXXXXXXXXXXXXXXXX
XXXXXXXXXXXXXXXXXXXXXXXXXXXXXXXXXXXXXXXXXXXXXXXXXXXXXXXXXXXXXXXXXXXXXXXXXXXXXXXXXXXXXXXXXXXXXXXXXXXXXXXXXXXXXXXXXXXX
XXXXXXXXXXXXXXXXXXXXXXXXXXXXXXXXXXXXXXXXXXXXXXXXXXXXXXXXXXXXXXXXXXXXXXXXXXXXXXXXXXXXXXXXXXXXXXXXXXXXXXXXXXXXXXXXXXXX
XXXXXXXXXXXXXXXXXXXXXXXXXXXXXXXXXXXXXXXXXXXXXXXXXXXXXXXXXXXXXXXXXXXXXXXXXXXXXXXXXXXXXXXXXXXXXXXXXXXXXXXXXXXXXXXXXXXX
XXXXXXXXXXXXXXXXXXXXXXXXXXXXXXXXXXXXXXXXXXXXXXXXXXXXXXXXXXXXXXXXXXXXXXXXXXXXXXXXXXXXXXXXXXXXXXXXXXXXXXXXXXXXXXXXXXXX
XXXXXXXXXXXXXXXXXXXXXXXXXXXXXXXXXXXXXXXXXXXXXXXXXXXXXXXXXXXXXXXXXXXXXXXXXXXXXXXXXXXXXXXXXXXXXXXXXXXXXXXXXXXXXXXXXXXX
XXXXXXXXXXXXXXXXXXXXXXXXXXXXXXXXXXXXXXXXXXXXXXXXXXXXXXXXXXXXXXXXXXXXXXXXXXXXXXXXXXXXXXXXXXXXXXXXXXXXXXXXXXXXXXXXXXXX
XXXXXXXXXXXXXXXXXXXXXXXXXXXXXXXXXXXXXXXXXXXXXXXXXXXXXXXXXXXXXXXXXXXXXXXXXXXXXXXXXXXXXXXXXXXXXXXXXXXXXXXXXXXXXXXXXXXX
XXXXXXXXXXXXXXXXXXXXXXXXXXXXXXXXXXXXXXXXXXXXXXXXXXXXXXXXXXXXXXXXXXXXXXXXXXXXXXXXXXXXXXXXXXXXXXXXXXXXXXXXXXXXXXXXXXXX