XXXXXXXXXXXXXXXXXXXXXXXXXXXXXXXXXXXXXXXXXXXXXXXXXXXXXXXXXXXXXXXXXXXXXXXXXXXXXXXXXXXXXXXXXXXXXXXXXXXXXXXXX
XXXXXXXXXXXXXXXXXXXXXXXXXXXXXXXXXXXXXXXXXXXXXXXXXXXXXXXXXXXXXXXXXXXXXXXXXXXXXXXXXXXXXXXXXXXXXXXXXXXXXXXXX
XXXXXXXXXXXXXXXXXXXXXXXXXXXXXXXXXXXXXXXXXXXXXXXXXXXXXXXXXXXXXXXXXXXXXXXXXXXXXXXXXXXXXXXXXXXXXXXXXXXXXXXXX
XXXXXXXXXXXXXXXXXXXXXXXXXXXXXXXXXXXXXXXXXXXXXXXXXXXXXXXXXXXXXXXXXXXXXXXXXXXXXXXXXXXXXXXXXXXXXXXXXXXXXXXXX
XXXXXXXXXXXXXXXXXXXXXXXWWWWWWWWWWWWWWWWWWWWWWWWWWWWWWWWWWWWWWWWWWWWWWWWWWWWWWWWWWWWWWXXXXXXXXXXXXXXXXXXXX
XXXXXXXXXXXXXXXXXXXXXXXWWWWWWWWWWWWWWWWWWWWWWWWWWWWWWWWWWWWWWWWWWWWWWWWWWWWWWWWWWWWWWXXXXXXXXXXXXXXXXXXXX
XXXXXXXXXXXXXXXXXXXXXXXWWWWWWWWWWWWWWWWWWWWWWWWWWWWWWWWWWWWWWWWWWWWWWWWWWWWWWWWWWWWWWXXXXXXXXXXXXXXXXXXXX
XXXXXXXXXXXXXXXXXXXXXXXWWWWWWWWWFFFFFFFFFFFFWWWWWWWWWWWWWWWWWWWWFFFFFFFFFFFFFFWWWWWWWXXXXXXXXXXXXXXXXXXXX
XXXXXXXXXXXXXXXXXXXXXXXWWWWWWWFFFFFFFFFFFFFFFFWWWWWWWWWWWWWWWWWWFFFFFFFFFFFFFFFWWWWWWXXXXXXXXXXXXXXXXXXXX
XXXXXXXXXXXXXXXXXXXXXXXWWWWWWFFFFFFFFFFFFFFFFFFFFFFFFFFOFFFFFFFFFFFFFFFFFFFFFFFFWWWWWXXXXXXXXXXXXXXXXXXXX
XXXXXXXXXXXXXXXXXXXXXXXWWWWWWFFFFFFFFFFFFFFFFFFFFFFFFFFFFFFFFFFFFFFFFFFFFFFFFFFFWWWWWXXXXXXXXXXXXXXXXXXXX
XXXXXXXXXXXXXXXXXXXXXXXWWWWWWFFFFFFTFFFFFFFFFFFFFFFFFFFAFFFFFFFFFFFFFFFFFFFFFFFFWWWWWXXXXXXXXXXXXXXXXXXXX
XXXXXXXXXXXXXXXXXXXXXXXWWWWWWFFFFFFFFFFFFFFFFFFFFFFFFFFFFFFFFFFFFFFFFFFFFFFFFFFFWWWWWXXXXXXXXXXXXXXXXXXXX
XXXXXXXXXXXXXXXXXXXXXXXWWWWWWFFFFFFFFFFFFFFFFFFFFFFFFFFFFFFFFFFFFFFFFFFFFFFFFFFFWWWWWXXXXXXXXXXXXXXXXXXXX
XXXXXXXXXXXXXXXXXXXXXXXWWWWWWFFFFFFFFFFFFFFFFFFFFFFFFFFFFFFFFFFFFFFFFFFFFFFFFFFFWWWWWXXXXXXXXXXXXXXXXXXXX
XXXXXXXXXXXXXXXXXXXXXXXWWWWWXXFFFFFFFFFFFFFFFFFFFFFFFFFFFFFFFFFFFFFFFFFFFFFFFFFWWWWWWXXXXXXXXXXXXXXXXXXXX
XXXXXXXXXXXXXXXXXXXXXXXWWWWWXXXXFFFFFFFFFFFFFFFFFFFFXFFFFXFFFFFFFFFFFFFFFFFFFXXXWWWWWXXXXXXXXXXXXXXXXXXXX
XXXXXXXXXXXXXXXXXXXXXXXWWWWWXXXXXXXXXXXXXXXXXXXXXXXXXFFFFXXXXXXXXXXXXXXXXXXXXXXXWWWWWXXXXXXXXXXXXXXXXXXXX
XXXXXXXXXXXXXXXXXXXXXXXWWWWWXXXXXXXXXXXXXXXXXXXXXXXXXFFFFXXXXXXXXXXXXXXXXXXXXXXXWWWWWXXXXXXXXXXXXXXXXXXXX
XXXXXXXXXXXXXXXXXXXXXXXWWWWWXXXXXXXXXXXXXXXXXXXXXXXXXFFFFXXXXXXXXXXXXXXXXXXXXXXXWWWWWXXXXXXXXXXXXXXXXXXXX
XXXXXXXXXXXXXXXXXXXXXXXWWWWWXXXXXXXXXXXXXXXXXXXXXXXXXFFFFXXXXXXXXXXXXXXXXXXXXXXXWWWWWXXXXXXXXXXXXXXXXXXXX
XXXXXXXXXXXXXXXXXXXXXXXWWWWWWXXXXXXXXXXXXXXXXXXXXXXXXFFFFXXXXXXXXXXXXXXXXXXXXXXXWWWWWXXXXXXXXXXXXXXXXXXXX
XXXXXXXXXXXXXXXXXXXXXXXWWWWWWXXXXXXXXXXXXXXXXXXXXXXXXFFFFXXXXXXXXXXXXXXXXXXXXXXXWWWWWXXXXXXXXXXXXXXXXXXXX
XXXXXXXXXXXXXXXXXXXXXXXWWWWWWWXXXXXXXXXXXXXXXXXXXXXXXFFFFXXXXXXXXXXXXXXXXXXXXXXWWWWWWXXXXXXXXXXXXXXXXXXXX
XXXXXXXXXXXXXXXXXXXXXXXWWWWWWWWXXXXXXXXXXXXXXXXXXXXXXFFFFXXXXXXXXXXXXXXXXXXXXXXWWWWWWXXXXXXXXXXXXXXXXXXXX
XXXXXXXXXXXXXXXXXXXXXXXWWWWWWWWWXXXXXFFFFFFFFFFFFFFFFFFFFFFFFFFFFFFFFFFFXXXXXXXWWWWWWXXXXXXXXXXXXXXXXXXXX
XXXXXXXXXXXXXXXXXXXXXXXWWWWWWWWWWXXXXFFFFFFFFFFFFFFFFFFPFFFFFFFFFFFFFFFFXXXXXXWWWWWWWXXXXXXXXXXXXXXXXXXXX
XXXXXXXXXXXXXXXXXXXXXXXWWWWWWWWWWXXXXFFFFFFFFFFFFFFFFFFFFFFFFFFFFFFFFFFFXXXXXWWWWWWWWXXXXXXXXXXXXXXXXXXXX
XXXXXXXXXXXXXXXXXXXXXXXWWWWWWWWWWWXXXFFFFFFFFFFFFFFFFFFFFFFFFFFFFFFFFFFFXXXXWWWWWWWWWXXXXXXXXXXXXXXXXXXXX
XXXXXXXXXXXXXXXXXXXXXXXWWWWWWWWWWWWWXFFFFFFFFFFFFFFFFFFFFFFFFFFFFFFFFFFFXXXWWWWWWWWWWXXXXXXXXXXXXXXXXXXXX
XXXXXXXXXXXXXXXXXXXXXXXWWWWWWWWWWWWWWFFFFFFFFFFFFFFFFFFYFFFFFFFFFFFFFFFFXXWWWWWWWWWWWXXXXXXXXXXXXXXXXXXXX
XXXXXXXXXXXXXXXXXXXXXXXWWWWWWWWWWWWWWFFFFFFFFFFFFFFFFFFFFFFFFFFFFFFFFFFFWWWWWWWWWWWWWXXXXXXXXXXXXXXXXXXXX
XXXXXXXXXXXXXXXXXXXXXXXWWWWWWWWWWWWWWWWWWWWWWWWWWWWWWWWWWWWWWWWWWWWWWWWWWWWWWWWWWWWWWXXXXXXXXXXXXXXXXXXXX
XXXXXXXXXXXXXXXXXXXXXXXWWWWWWWWWWWWWWWWWWWWWWWWWWWWWWWWWWWWWWWWWWWWWWWWWWWWWWWWWWWWWWXXXXXXXXXXXXXXXXXXXX
XXXXXXXXXXXXXXXXXXXXXXXWWWWWWWWWWWWWWWWWWWWWWWWWWWWWWWWWWWWWWWWWWWWWWWWWWWWWWWWWWWWWWXXXXXXXXXXXXXXXXXXXX
XXXXXXXXXXXXXXXXXXXXXXXWWWWWWWWWWWWWWWWWWWWWWWWWWWWWWWWWWWWWWWWWWWWWWWWWWWWWWWWWWWWWWXXXXXXXXXXXXXXXXXXXX
XXXXXXXXXXXXXXXXXXXXXXXXXXXXXXXXXXXXXXXXXXXXXXXXXXXXXXXXXXXXXXXXXXXXXXXXXXXXXXXXXXXXXXXXXXXXXXXXXXXXXXXXX
XXXXXXXXXXXXXXXXXXXXXXXXXXXXXXXXXXXXXXXXXXXXXXXXXXXXXXXXXXXXXXXXXXXXXXXXXXXXXXXXXXXXXXXXXXXXXXXXXXXXXXXXX
XXXXXXXXXXXXXXXXXXXXXXXXXXXXXXXXXXXXXXXXXXXXXXXXXXXXXXXXXXXXXXXXXXXXXXXXXXXXXXXXXXXXXXXXXXXXXXXXXXXXXXXXX
XXXXXXXXXXXXXXXXXXXXXXXXXXXXXXXXXXXXXXXXXXXXXXXXXXXXXXXXXXXXXXXXXXXXXXXXXXXXXXXXXXXXXXXXXXXXXXXXXXXXXXXXX