XXXXXXXXXXXXXXXXXXXXXXXXXXXXXXXXXXXXXXXXXXXXXXXXXXXXXXXXXXXXXXXXXXXXXXXXXXXXXXXXXXXXXXXXXXXXXXXXXXXXXXXXXXXXXXXXXXX
XXXXXXXXXXXXXXXXXXXXXXXXXXXXXXXXXXXXXXXXXXXXXXXXXXXXXXXXXXXXXXXXXXXXXXXXXXXXXXXXXXXXXXXXXXXXXXXXXXXXXXXXXXXXXXXXXXX
XXXXXXXXXXXXXXXXXXXXXXXXXXXXXXXXXXXXXXXXXXXXXXXXXXXXXXXXXXXXXXXXXXXXXXXXXXXXXXXXXXXXXXXXXXXXXXXXXXXXXXXXXXXXXXXXXXX
XXXXXXXXXXXXXXXXXXXXXXXXXXXXXXXXXXXXXXXXXXXXXXXXXXXXXXXXXXXXXXXXXXXXXXXXXXXXXXXXXXXXXXXXXXXXXXXXXXXXXXXXXXXXXXXXXXX
XXXXXXXXXXXXXXXXXXXXXXXXXXXXXXXXXXXXXXXXXXXXXXXXXXXXXXXXXXXXXXXXXXXXXXXXXXXXXXXXXXXXXXXXXXXXXXXXXXXXXXXXXXXXXXXXXXX
XXXXXXXXXXXXXXXXXXXXXWWWWWWWWWWWWWWWWWWWWWWWWWWWWWWWWWWWWWWWWWWWWWWWWWWWWWWWWWWWWWWWWWWWWWWWWWWWWWWWWWWWWWWWWWXXXXX
XXXXXXXXXXXXXXXXXXXXXWFFFSFFFFFFFFFFFFFFFFFFFFFFFFLLLLLLLLLFFFFSFFFFFFFFFFFFFFFFFFFFFFFFFFFFFFFFFFFFFFFFFFFFWWXXXXX
XXXXXXXXXXXXXXXXXXXXXWFFFFFFFFFFFFFFFFFFFFFFFFFFFFFFFFFFFFFFFFFFFFFFFFFFFFFFFFFFFFFFFFFFFFFFFFFFFFFFFFFFFFFFFWXXXXX
XXXXXXXXXXXXXXXXXXXXXWFFFFFFmmmmmmmmFFFFFFFFFFFFFFFFFFFFFFFFFFFFFFFFFFFFFFFFFFFFFFFFFFFFFFFFFFFFFFFFFFFFFFFFFWXXXXX
XXXXXXXXXXXXXXXXXXXXXWFFFFFFFFFFFFFFFFFFFFFFFFFFFFFFFFFFFFFFFFFFFFFFFFFFFFFFFRFFFFFF-FFFFFFFFFFFFFFFFFFFFFFFFWXXXXX
XXXXXXXXXXXXXXXXXXXXXWFFFFFFFFFFFFFFFFFFFFFFFFFFFFFFFFFFFFFFWWWWFFFFFFFFFFFFFRFFFFFFRFFFFFFFFFFFFFFFFFFFFFFFFWXXXXX
XXXXXXXXXXXXXXXXXXXXXWFFFFFFFFFFFFFFFFFFFFFFFFFFFFFFFFFFFFFFWWWWFFFFFFFFFFFFFFFFFFFFRFFFFFFFFFFFFFFFFFFFFFFFFWXXXXX
XXXXXXXXXXXXXXXXXXXXXWFFFFFFFFFFFFFFRRRRRRRRRRFFFFFFFFFFFFFFFFFFFFFFFFFFFFFFRRFFFFFFRFFFFFFFFFFFFFFFFFFFFFFFFWXXXXX
XXXXXXXXXXXXXXXXXXXXXWFFFFFFFFFFFFFFRFFFFFFFFRFFFFFFFFFFFFFFFFFFFOOOOFFFFFFFRRFFFFFFRFFFFFFFFFFFFFFFFFFFFFFFFWXXXXX
XXXXXXXXXXXXXXXXXXXXXWFFTFFFFFFFFFFFRFFFFFFFFRFFFFFFFFWWWWWWWFFFFppppppppFFFFFFFFFFFRFFFFFFFFFFFFFFFFFFFFFFWWWXXXXX
XXXXXXXXXXXXXXXXXXXXXWFFFFFFFFFFFFFFRFFFFFFFFRFFFFFFFFWWWWWWWFFFFccccccccFFWWWFFFFFFFFFFFFFFFFFFFFFFFFFFFFFWWWXXXXX
XXXXXXXXXXXXXXXXXXXXXWFFFFFFFFFFFFFFRRRRRRRRRRFFFFFFFFFFFffffffFFbbbbbbbbWWWFFFFFFFFFFFFFFFFFFFFFFFFFFFFFFFFWWXXXXX
XXXXXXXXXXXXXXXXXXXXXWFFFFFFFFFFFFFFFFFFFFFFTTTTFFFFFFFFFooooFFFFFPFFFFFFFFFFFFFFFFFFFFFFFFFFFFFFFFFFFFFFFFFFWXXXXX
XXXXXXXXXXXXXXXXXXXXXWFFFFFFFFFFFFFFFFFFFFFFTTTTFFFFFFFFFooooFFFFFFFFFWWWOOOOFFFFFFFFFFFFFFFFFFFFFFFFFFFFFFFFWXXXXX
XXXXXXXXXXXXXXXXXXXXXWFFFFFFFFFFTTFFFFFFFFFFTTTTFFFFFFFWWWFWWFmmmmFFFFWWWPPPPFFFFFFFFFFFFFFFFFFFFFFFFFFFFFFFFWXXXXX
XXXXXXXXXXXXXXXXXXXXXWFFFFFFFFFFTTFFFTTFFFFFTTTTFFFFFFFWWXXWWFmmmmFFFFWWWCCCCFWWFFFFFFFFFFFFFFFFFFFTFFFFFFFFFWXXXXX
XXXXXXXXXXXXXXXXXXXXXWFFFFFFFFFFFFTFFTTFFFFFFFFFFFFFFFFfXXXXWFFFFFWFFFFFFBBBBFWWFFFFFFFFFFFFFFFFFFFFFFFFFFFFFWXXXXX
XXXXXXXXXXXXXXXXXXXXXWWFFFFFFFFFFFFFFTTFFFFFFFFFFFFFFFFWXXXXWFFWFFWFTTTFWFFFFFWWFFFFFWFWFFFWWWFFFWWFFFFFFFFFFWXXXXX
XXXXXXXXXXXXXXXXXXXXXXWWWWWWWWWWWWWWWWWWWWWWWWWWWWWWWWWWXXXXWWWWWWWWWWWWWWWWWWWWWWWWWWWWWWWWXWWWWWWWWWWWWWWWWWXXXXX
XXXXXXXXXXXXXXXXXXXXXXXXXXXXXXXXXXXXXXXXXXXXXXXXXXXXXXXXXXXXXXXXXXXXXXXXXXXXXXXXXXXXXXXXXXXXXXXXXXXXXXXXXXXXXXXXXXX
XXXXXXXXXXXXXXXXXXXXXXXXXXXXXXXXXXXXXXXXXXXXXXXXXXXXXXXXXXXXXXXXXXXXXXXXXXXXXXXXXXXXXXXXXXXXXXXXXXXXXXXXXXXXXXXXXXX
XXXXXXXXXXXXXXXXXXXXXXXXXXXXXXXXXXXXXXXXXXXXXXXXXXXXXXXXXXXXXXXXXXXXXXXXXXXXXXXXXXXXXXXXXXXXXXXXXXXXXXXXXXXXXXXXXXX
XXXXXXXXXXXXXXXXXXXXXXXXXXXXXXXXXXXXXXXXXXXXXXXXXXXXXXXXXXXXXXXXXXXXXXXXXXXXXXXXXXXXXXXXXXXXXXXXXXXXXXXXXXXXXXXXXXX