XXXXXXXXXXXXXXXXXXXXXXXXXXXXXXXXXXXXXXXXXXXXXXXXXXXXXXXXXXXXXXXXXXXXXXXXXXXXXXXXXXXXXXXXXXXXXXXXXXXXXXXXXXXXXXXXXXX
XXXXXXXXXXXXXXXXXXXXXXXXXXXXXXXXXXXXXXXXXXXXXXXXXXXXXXXXXXXXXXXXXXXXXXXXXXXXXXXXXXXXXXXXXXXXXXXXXXXXXXXXXXXXXXXXXXX
XXXXXXXXXXXXXXXXXXXXXXXXXXXXXXXXXXXXXXXXXXXXXXXXXXXXXXXXXXXXXXXXXXXXXXXXXXXXXXXXXXXXXXXXXXXXXXXXXXXXXXXXXXXXXXXXXXX
XXXXXXXXXXXXXXXXXXXXXXXXXXXXXXXXXXXXXXXXXXXXXXXXXXXXXXXXXXXXXXXXXXXXXXXXXXXXXXXXXXXXXXXXXXXXXXXXXXXXXXXXXXXXXXXXXXX
XXXXXXXXXXXXXXXXXXXXXXXXXXXXXXXXXXXXXXXXXXXXXXXXXXXXXXXXXXXXXXXXXXXXXXXXXXXXXXXXXXXXXXXXXXXXXXXXXXXXXXXXXXXXXXXXXXX
XXXXXXXXXXXXXXXXXXXXXWWWWWWWWWWWWWWWWWWWWWWWWWWWWWWWWWWWWWWWWWWWWWWWWWWWWWWWWWWWWWWWWWWWWWWWWWWWWWWWWWWWWWWWWWXXXXX
XXXXXXXXXXXXXXXXXXXXXWFFFFFFFFFFFFFFFFFFFFFFFFFFFFFFFFFFFFFFFFFFFFFFFFFFFFFFFFFFFFFFFFFFFFFFFFFFFFFFFFFFFFFFWWXXXXX
XXXXXXXXXXXXXXXXXXXXXWFFFFFFFFFFFFFFFFFFFFFFFFFFFFFFFFFFFFFFFFFFFFFFFFFFFFFFFFFFFFFFFFFFFFFFFFFFFFFFFFFFFFFFFWXXXXX
XXXXXXXXXXXXXXXXXXXXXWFFFFFFFFFFFFFFFFFFFFFFFFFFFFFFFFFFFFFFFFFFFFFFFFFFFFFFFFFFFFFFFFFFFFFFFFFFFFFFFFFFFFFFFWXXXXX
XXXXXXXXXXXXXXXXXXXXXWFFFFFFFFFFFFFFFFFFFFFFFFFFFFFFFFFFFFFFFFFFFFFFFFFFFFFFFFFFFFFFFFFFFFFFFFFFFFFFFFFFFFFFFWXXXXX
XXXXXXXXXXXXXXXXXXXXXWFFFFFFFFFFFFFFFFFFFFFFFFFFFFFFFFFFFFFFWWWWWWWWWFFFFFFFFFFFFFFFFFFFFFFFFFFFFFFFFFFFFFFFFWXXXXX
XXXXXXXXXXXXXXXXXXXXXWFFFFFFFFFFFFFFFFFFFFFFFFFFFFFFFFFFFFFFWWWWWWWWWFFFFFFFFFFFFFFFFFFFFFFFFFFFFFFFFFFFFFFFFWXXXXX
XXXXXXXXXXXXXXXXXXXXXWFFFFFFFFFFFFFFFFFFFFFFFFFFFFFFFFFFFFFFWWFFFFFWWFFFFFFFFFFFFFFFFFFFFFFFFFFFFFFFFFFFFFFFFWXXXXX
XXXXXXXXXXXXXXXXXXXXXWFFFFFFFFFFFFFFFFFFFFFFFFFFFFFFFFFFFFFFWWFFFFFWWFFFFFFFFFFFWWFFFFFFFFFFFFFFFFFFFFFFFFFFFWXXXXX
XXXXXXXXXXXXXXXXXXXXXWFFTFFFFFFFFFFFFFFFFFFFFFFFFFFFFFFFFFFFFFFFFFFFFFFFFWWWFFFFWWFFFFFFFFFFFFFFFFFFFFFFFFFWWWXXXXX
XXXXXXXXXXXXXXXXXXXXXWFFFFFFFFFFFFFFFFFFFFFFFFFFFFFFFFFFFFFFFFFFFFFFFFFFFWWWFFFFFFFFFFFFFFFFFFFFFFFFFFFFFFFWWWXXXXX
XXXXXXXXXXXXXXXXXXXXXWFFFFFFFFFFFFFFFFFFFFFFFFFFFFFFFFFFFFFBBBBBBBFFFFFFFFFFFFFFFFFFFFFFFFFFFFFFFFFFFFFFFFFWWWXXXXX
XXXXXXXXXXXXXXXXXXXXXWFFFFFFFFFFFFFFFFFFFFFFFFFFFFFFFFFFFFFBBBBBBBPFFFFFFFFFFFFFFFFFFFFFFFFFFFFFFFFFFFFFFFFFFWXXXXX
XXXXXXXXXXXXXXXXXXXXXWFFFFFFFFFFFFFFFFFFFFFFFFFFFFFFFFFFFFFBBBBBBBFFWWWWWWWFFFFFFFFFFFFFFFFFFFFFFFFFFFFFFFFFFWXXXXX
XXXXXXXXXXXXXXXXXXXXXWFFFFFFFFFFFFFFFFFFFFFFFFFFFFFFFFFWWWWWWFFFFFFFWWWWWWWFFFFFFFFFFFFFFFFFFFFFFFFFFFFFFFFFFWXXXXX
XXXXXXXXXXXXXXXXXXXXXWFFFFFFFFFFFFFFFFFFFFFFFFFFFFFFFFFWWXXWWFFFFFFFFFWWWFFFFFWWFFFFFFFFFFFFFFFFFFFTFFFFFFFFFWXXXXX
XXXXXXXXXXXXXXXXXXXXXWFFFFFFFFFFFFTFFFFFFFFFFFFFFFFFFFFWXXXXWFFFFFFFFFWWWFFFFFWWFFFFFFFFFFFFFFFFFFFFFFFFFFFFFWXXXXX
XXXXXXXXXXXXXXXXXXXXXWWFFFFFFFFFFFFFFFFFFFFFFFFFFFFFFFFWXXXXWFFFFFFFFFFFFFFFFFWWFFFWWFFFFFFWWWFFFWWFFFFFFFFFFWXXXXX
XXXXXXXXXXXXXXXXXXXXXWWWWWWWWWWWWWWWWWWWWWWWWWWWWWWWWWWWXXXXWWWWWWWWWWWWWWWWWWWWWWWWWWWWWWWWWWWWWWWWWWWWWWWWWWXXXXX
XXXXXXXXXXXXXXXXXXXXXXXXXXXXXXXXXXXXXXXXXXXXXXXXXXXXXXXXXXXXXXXXXXXXXXXXXXXXXXXXXXXXXXXXXXXXXXXXXXXXXXXXXXXXXXXXXXX
XXXXXXXXXXXXXXXXXXXXXXXXXXXXXXXXXXXXXXXXXXXXXXXXXXXXXXXXXXXXXXXXXXXXXXXXXXXXXXXXXXXXXXXXXXXXXXXXXXXXXXXXXXXXXXXXXXX
XXXXXXXXXXXXXXXXXXXXXXXXXXXXXXXXXXXXXXXXXXXXXXXXXXXXXXXXXXXXXXXXXXXXXXXXXXXXXXXXXXXXXXXXXXXXXXXXXXXXXXXXXXXXXXXXXXX
XXXXXXXXXXXXXXXXXXXXXXXXXXXXXXXXXXXXXXXXXXXXXXXXXXXXXXXXXXXXXXXXXXXXXXXXXXXXXXXXXXXXXXXXXXXXXXXXXXXXXXXXXXXXXXXXXXX